1111111111111
10010CC0000C1
10000111110E1
10P011E000001
1111111111111